##########
#P.......#
#.......I#
#........#
#..#######
#.......E#
#..#####.#
#......#.#
#.I..I.#X#
##########