##########
#P.......#
#....#.#I#
#...######
#.....E.I#
#E..######
#........#
#.....E..#
#..E....X#
##########