##########
#P....E..#
#.####...#
#..I.....#
#.####.#.#
#.....E#.#
#...I....#
#.#.####.#
#.....#.X#
##########