##########
#P....E..#
#..###...#
#..#.....#
#..#..I..#
#..#####.#
#..#....I#
#..E.....#
#.....#.X#
##########
