##########
#P.......#
#..E.....#
#..#..I..#
#..#.....#
#..###...#
#........#
#........#
#.......X#
##########